#module 0 size: 18 bs: 5.69337e-101
7 10 13 17 18 22 28 31 33 37 38 41 44 45 47 50 51 56 
#module 1 size: 28 bs: 7.01661e-14
1 2 3 4 9 15 21 23 27 30 34 43 46 48 49 53 60 63 68 70 72 73 74 78 79 81 83 93 
#module 2 size: 35 bs: 0.000478335
5 11 16 25 32 35 36 40 57 61 62 64 69 75 76 77 80 82 84 85 86 87 88 89 90 91 92 93 94 95 96 97 98 99 100 
#module 3 size: 15 bs: 9.9698e-14
6 19 20 29 42 52 54 55 58 59 65 66 67 71 97 
#module 4 size: 12 bs: 0.00779992
124 135 145 154 161 167 179 184 185 187 188 200 
#module 5 size: 47 bs: 0.016264
102 107 111 112 117 119 120 125 126 127 128 130 132 133 134 137 138 150 152 153 156 157 158 162 165 168 169 170 171 172 174 177 180 181 186 189 190 191 192 193 194 195 196 197 198 199 200 
#module 6 size: 26 bs: 9.07713e-09
103 106 114 116 121 123 136 139 140 141 142 143 144 146 147 148 149 151 155 159 160 166 171 175 176 183 
#module 7 size: 100 bs: 3.76825e-101
201 202 203 204 205 206 207 208 209 210 211 212 213 214 215 216 217 218 219 220 221 222 223 224 225 226 227 228 229 230 231 232 233 234 235 236 237 238 239 240 241 242 243 244 245 246 247 248 249 250 251 252 253 254 255 256 257 258 259 260 261 262 263 264 265 266 267 268 269 270 271 272 273 274 275 276 277 278 279 280 281 282 283 284 285 286 287 288 289 290 291 292 293 294 295 296 297 298 299 300 
#module 0 size: 18 bs: 7.24772e-101
7 10 13 17 18 22 28 31 33 37 38 41 44 45 47 50 51 56 
#module 1 size: 28 bs: 7.01661e-14
1 2 3 4 9 15 21 23 27 30 34 43 46 48 49 53 60 63 68 70 72 73 74 78 79 81 83 93 
#module 2 size: 35 bs: 0.000478335
5 11 16 25 32 35 36 40 57 61 62 64 69 75 76 77 80 82 84 85 86 87 88 89 90 91 92 93 94 95 96 97 98 99 100 
#module 3 size: 15 bs: 9.9698e-14
6 19 20 29 42 52 54 55 58 59 65 66 67 71 97 
#module 4 size: 12 bs: 0.0785252
124 135 145 154 161 167 179 184 185 187 188 200 
#module 5 size: 44 bs: 0.0162639
102 107 111 112 117 119 125 126 127 128 132 133 134 137 138 150 152 153 156 157 158 162 165 168 169 170 171 172 174 177 180 181 186 189 190 191 192 193 194 195 196 197 198 199 
#module 6 size: 26 bs: 3.73622e-07
103 106 114 116 121 123 136 139 140 141 142 143 144 146 147 148 149 151 155 159 160 166 171 175 176 183 
#module 7 size: 59 bs: 1.60811e-08
201 203 204 206 208 210 211 212 213 216 217 218 219 222 223 224 225 226 227 229 230 232 234 237 239 240 242 243 244 245 247 248 249 253 254 256 259 262 263 264 265 266 267 270 272 274 276 277 282 284 285 286 288 289 291 294 295 296 297 
#module 8 size: 41 bs: 0.000296795
202 205 207 209 214 215 220 221 228 231 233 235 236 238 241 246 250 251 252 255 257 258 260 261 268 269 271 273 275 278 279 280 281 283 287 290 292 293 298 299 300 
#module 0 size: 18 bs: 7.54669e-102
7 10 13 17 18 22 28 31 33 37 38 41 44 45 47 50 51 56 
#module 1 size: 28 bs: 7.01661e-14
1 2 3 4 9 15 21 23 27 30 34 43 46 48 49 53 60 63 68 70 72 73 74 78 79 81 83 93 
#module 2 size: 35 bs: 0.000478335
5 11 16 25 32 35 36 40 57 61 62 64 69 75 76 77 80 82 84 85 86 87 88 89 90 91 92 93 94 95 96 97 98 99 100 
#module 3 size: 15 bs: 9.9698e-14
6 19 20 29 42 52 54 55 58 59 65 66 67 71 97 
#module 4 size: 12 bs: 8.8094e-05
124 135 145 154 161 167 179 184 185 187 188 200 
#module 5 size: 47 bs: 0.00955756
102 107 111 112 117 119 120 125 126 127 128 130 132 133 134 137 138 150 152 153 156 157 158 162 165 168 169 170 171 172 174 177 180 181 186 189 190 191 192 193 194 195 196 197 198 199 200 
#module 6 size: 26 bs: 0.0162639
103 106 114 116 121 123 136 139 140 141 142 143 144 146 147 148 149 151 155 159 160 166 171 175 176 183 
#module 7 size: 100 bs: 2.43517e-101
201 202 203 204 205 206 207 208 209 210 211 212 213 214 215 216 217 218 219 220 221 222 223 224 225 226 227 228 229 230 231 232 233 234 235 236 237 238 239 240 241 242 243 244 245 246 247 248 249 250 251 252 253 254 255 256 257 258 259 260 261 262 263 264 265 266 267 268 269 270 271 272 273 274 275 276 277 278 279 280 281 282 283 284 285 286 287 288 289 290 291 292 293 294 295 296 297 298 299 300 
#module 0 size: 18 bs: 2.21853e-101
7 10 13 17 18 22 28 31 33 37 38 41 44 45 47 50 51 56 
#module 1 size: 28 bs: 7.01661e-14
1 2 3 4 9 15 21 23 27 30 34 43 46 48 49 53 60 63 68 70 72 73 74 78 79 81 83 93 
#module 2 size: 35 bs: 0.000478335
5 11 16 25 32 35 36 40 57 61 62 64 69 75 76 77 80 82 84 85 86 87 88 89 90 91 92 93 94 95 96 97 98 99 100 
#module 3 size: 15 bs: 9.9698e-14
6 19 20 29 42 52 54 55 58 59 65 66 67 71 97 
#module 4 size: 53 bs: 6.05971e-10
201 203 204 206 208 210 211 212 213 216 218 219 222 223 225 227 230 234 237 242 243 244 245 247 248 249 253 254 256 259 262 263 264 265 266 267 270 272 274 276 277 282 284 285 286 288 289 291 294 295 296 297 299 
#module 5 size: 12 bs: 6.67027e-10
214 215 252 275 278 279 281 287 290 293 298 300 
#module 6 size: 12 bs: 0.0063751
124 135 145 154 161 167 179 184 185 187 188 200 
#module 7 size: 43 bs: 0.016264
102 107 111 112 117 119 125 126 127 128 130 132 133 137 138 150 152 153 156 157 158 165 168 169 170 171 172 174 177 180 181 186 189 190 191 192 193 194 195 196 197 198 199 
#module 8 size: 26 bs: 6.62553e-08
103 106 114 116 121 123 136 139 140 141 142 143 144 146 147 148 149 151 155 159 160 166 171 175 176 183 
#module 0 size: 18 bs: 9.24793e-101
7 10 13 17 18 22 28 31 33 37 38 41 44 45 47 50 51 56 
#module 1 size: 28 bs: 7.01661e-14
1 2 3 4 9 15 21 23 27 30 34 43 46 48 49 53 60 63 68 70 72 73 74 78 79 81 83 93 
#module 2 size: 35 bs: 0.000478335
5 11 16 25 32 35 36 40 57 61 62 64 69 75 76 77 80 82 84 85 86 87 88 89 90 91 92 93 94 95 96 97 98 99 100 
#module 3 size: 15 bs: 9.9698e-14
6 19 20 29 42 52 54 55 58 59 65 66 67 71 97 
#module 4 size: 52 bs: 0.0025921
201 203 204 206 208 210 212 213 216 217 218 219 222 224 225 226 227 230 232 234 237 242 244 245 247 248 249 253 254 256 259 263 264 265 266 267 270 272 274 276 277 282 284 286 288 289 291 294 295 296 297 299 
#module 5 size: 12 bs: 0.00278699
214 215 252 275 278 279 281 287 290 293 298 300 
#module 6 size: 12 bs: 1.75998e-05
124 135 145 154 161 167 179 184 185 187 188 200 
#module 7 size: 47 bs: 1.46529e-06
102 107 111 112 117 119 120 125 126 127 128 130 132 133 134 137 138 150 152 153 156 157 158 162 165 168 169 170 171 172 174 177 180 181 186 189 190 191 192 193 194 195 196 197 198 199 200 
#module 8 size: 26 bs: 2.98147e-05
103 106 114 116 121 123 136 139 140 141 142 143 144 146 147 148 149 151 155 159 160 166 171 175 176 183 
#module 0 size: 18 bs: 7.26918e-101
7 10 13 17 18 22 28 31 33 37 38 41 44 45 47 50 51 56 
#module 1 size: 28 bs: 7.01661e-14
1 2 3 4 9 15 21 23 27 30 34 43 46 48 49 53 60 63 68 70 72 73 74 78 79 81 83 93 
#module 2 size: 35 bs: 0.000478335
5 11 16 25 32 35 36 40 57 61 62 64 69 75 76 77 80 82 84 85 86 87 88 89 90 91 92 93 94 95 96 97 98 99 100 
#module 3 size: 15 bs: 9.9698e-14
6 19 20 29 42 52 54 55 58 59 65 66 67 71 97 
#module 4 size: 13 bs: 0.00779991
124 135 145 154 161 167 179 182 184 185 187 188 200 
#module 5 size: 47 bs: 0.0109653
102 107 111 112 117 119 120 125 126 127 128 130 132 133 134 137 138 150 152 153 156 157 158 162 165 168 169 170 171 172 174 177 180 181 186 189 190 191 192 193 194 195 196 197 198 199 200 
#module 6 size: 26 bs: 9.07713e-09
103 106 114 116 121 123 136 139 140 141 142 143 144 146 147 148 149 151 155 159 160 166 171 175 176 183 
#module 7 size: 60 bs: 0.000433089
201 203 204 205 206 208 210 211 212 213 216 217 218 219 222 223 224 225 226 227 229 230 232 234 237 239 240 242 243 244 245 247 248 249 253 254 256 259 262 263 264 265 266 267 270 272 274 276 277 282 284 285 286 288 289 291 294 295 296 297 
#module 8 size: 40 bs: 1.13688e-11
202 207 209 214 215 220 221 228 231 233 235 236 238 241 246 250 251 252 255 257 258 260 261 268 269 271 273 275 278 279 280 281 283 287 290 292 293 298 299 300 
#module 0 size: 18 bs: 3.89071e-101
7 10 13 17 18 22 28 31 33 37 38 41 44 45 47 50 51 56 
#module 1 size: 28 bs: 7.01661e-14
1 2 3 4 9 15 21 23 27 30 34 43 46 48 49 53 60 63 68 70 72 73 74 78 79 81 83 93 
#module 2 size: 35 bs: 0.000478335
5 11 16 25 32 35 36 40 57 61 62 64 69 75 76 77 80 82 84 85 86 87 88 89 90 91 92 93 94 95 96 97 98 99 100 
#module 3 size: 15 bs: 9.9698e-14
6 19 20 29 42 52 54 55 58 59 65 66 67 71 97 
#module 4 size: 12 bs: 0.00988883
124 135 145 154 161 167 179 184 185 187 188 200 
#module 5 size: 47 bs: 0.016264
102 107 111 112 117 119 120 125 126 127 128 130 132 133 134 137 138 150 152 153 156 157 158 162 165 168 169 170 171 172 174 177 180 181 186 189 190 191 192 193 194 195 196 197 198 199 200 
#module 6 size: 26 bs: 9.07712e-09
103 106 114 116 121 123 136 139 140 141 142 143 144 146 147 148 149 151 155 159 160 166 171 175 176 183 
#module 7 size: 100 bs: 8.88209e-101
201 202 203 204 205 206 207 208 209 210 211 212 213 214 215 216 217 218 219 220 221 222 223 224 225 226 227 228 229 230 231 232 233 234 235 236 237 238 239 240 241 242 243 244 245 246 247 248 249 250 251 252 253 254 255 256 257 258 259 260 261 262 263 264 265 266 267 268 269 270 271 272 273 274 275 276 277 278 279 280 281 282 283 284 285 286 287 288 289 290 291 292 293 294 295 296 297 298 299 300 
#module 0 size: 18 bs: 8.03084e-101
7 10 13 17 18 22 28 31 33 37 38 41 44 45 47 50 51 56 
#module 1 size: 73 bs: 4.13856e-101
201 203 204 205 206 208 210 211 212 213 214 215 216 217 218 219 222 223 224 225 226 227 229 230 232 234 237 239 240 242 243 244 245 247 248 249 252 253 254 256 259 262 263 264 265 266 267 270 272 274 275 276 277 278 279 281 282 284 285 286 287 288 289 290 291 293 294 295 296 297 298 299 300 
#module 2 size: 28 bs: 7.01661e-14
1 2 3 4 9 15 21 23 27 30 34 43 46 48 49 53 60 63 68 70 72 73 74 78 79 81 83 93 
#module 3 size: 35 bs: 0.000478335
5 11 16 25 32 35 36 40 57 61 62 64 69 75 76 77 80 82 84 85 86 87 88 89 90 91 92 93 94 95 96 97 98 99 100 
#module 4 size: 15 bs: 9.9698e-14
6 19 20 29 42 52 54 55 58 59 65 66 67 71 97 
#module 5 size: 13 bs: 0.0025921
124 135 145 154 161 167 179 182 184 185 187 188 200 
#module 6 size: 47 bs: 0.0109652
102 107 111 112 117 119 120 125 126 127 128 130 132 133 134 137 138 150 152 153 156 157 158 162 165 168 169 170 171 172 174 177 180 181 186 189 190 191 192 193 194 195 196 197 198 199 200 
#module 7 size: 26 bs: 9.07712e-09
103 106 114 116 121 123 136 139 140 141 142 143 144 146 147 148 149 151 155 159 160 166 171 175 176 183 
#module 0 size: 18 bs: 3.20889e-101
7 10 13 17 18 22 28 31 33 37 38 41 44 45 47 50 51 56 
#module 1 size: 28 bs: 7.01661e-14
1 2 3 4 9 15 21 23 27 30 34 43 46 48 49 53 60 63 68 70 72 73 74 78 79 81 83 93 
#module 2 size: 35 bs: 0.000478335
5 11 16 25 32 35 36 40 57 61 62 64 69 75 76 77 80 82 84 85 86 87 88 89 90 91 92 93 94 95 96 97 98 99 100 
#module 3 size: 15 bs: 9.9698e-14
6 19 20 29 42 52 54 55 58 59 65 66 67 71 97 
#module 4 size: 12 bs: 0.0025921
214 215 252 275 278 279 281 287 290 293 298 300 
#module 5 size: 51 bs: 1.5466e-07
201 203 204 206 208 210 211 213 216 218 219 224 225 227 229 230 234 237 239 242 244 245 247 248 249 253 254 256 259 263 264 265 266 267 270 272 274 276 277 282 284 285 286 288 289 291 294 295 296 297 299 
#module 6 size: 12 bs: 1.28713e-08
124 135 145 154 161 167 179 184 185 187 188 200 
#module 7 size: 47 bs: 0.000380799
102 107 111 112 117 119 120 125 126 127 128 130 132 133 134 137 138 150 152 153 156 157 158 162 165 168 169 170 171 172 174 177 180 181 186 189 190 191 192 193 194 195 196 197 198 199 200 
#module 8 size: 26 bs: 9.53692e-08
103 106 114 116 121 123 136 139 140 141 142 143 144 146 147 148 149 151 155 159 160 166 171 175 176 183 
#module 0 size: 18 bs: 2.38103e-101
7 10 13 17 18 22 28 31 33 37 38 41 44 45 47 50 51 56 
#module 1 size: 28 bs: 7.01661e-14
1 2 3 4 9 15 21 23 27 30 34 43 46 48 49 53 60 63 68 70 72 73 74 78 79 81 83 93 
#module 2 size: 35 bs: 0.000478335
5 11 16 25 32 35 36 40 57 61 62 64 69 75 76 77 80 82 84 85 86 87 88 89 90 91 92 93 94 95 96 97 98 99 100 
#module 3 size: 15 bs: 9.9698e-14
6 19 20 29 42 52 54 55 58 59 65 66 67 71 97 
#module 4 size: 13 bs: 0.0025921
214 215 252 268 275 278 279 281 287 290 293 298 300 
#module 5 size: 52 bs: 3.16926e-06
203 204 208 210 212 213 216 217 218 222 224 225 226 227 229 230 232 234 237 239 242 243 245 247 248 249 253 254 256 259 263 264 265 266 267 270 272 274 276 277 282 284 285 286 288 289 291 294 295 296 297 299 
#module 6 size: 12 bs: 0.00955755
124 135 145 154 161 167 179 184 185 187 188 200 
#module 7 size: 38 bs: 2.66198e-08
102 111 112 119 125 126 128 132 133 134 137 138 150 153 157 158 162 168 169 170 171 172 174 177 180 181 186 189 190 191 192 193 194 195 196 197 198 199 
#module 8 size: 26 bs: 5.98988e-07
103 106 114 116 121 123 136 139 140 141 142 143 144 146 147 148 149 151 155 159 160 166 171 175 176 183 
