#module 0 size: 14 bs: 0.0135819
1 2 3 4 5 6 7 8 11 13 14 17 18 22 
#module 1 size: 18 bs: 0.0160003
3 9 10 15 16 19 21 24 25 26 27 28 29 30 31 32 33 34 
#module 0 size: 14 bs: 0.0135819
1 2 3 4 5 6 7 8 11 13 14 17 18 22 
#module 1 size: 16 bs: 0.0985408
9 15 16 19 21 24 25 26 27 28 29 30 31 32 33 34 
#module 0 size: 16 bs: 0.0985411
9 15 16 19 21 24 25 26 27 28 29 30 31 32 33 34 
#module 1 size: 14 bs: 0.0115997
1 2 3 4 5 6 7 8 11 13 14 17 18 22 
#module 0 size: 14 bs: 0.0135819
1 2 3 4 5 6 7 8 11 13 14 17 18 22 
#module 1 size: 14 bs: 0.00848675
15 16 19 21 24 25 26 27 28 29 30 32 33 34 
#module 0 size: 14 bs: 0.0135819
1 2 3 4 5 6 7 8 11 13 14 17 18 22 
#module 1 size: 18 bs: 0.0132312
3 9 10 15 16 19 21 24 25 26 27 28 29 30 31 32 33 34 
#module 0 size: 13 bs: 0.0115997
15 16 19 21 24 25 26 27 28 30 32 33 34 
#module 1 size: 15 bs: 0.0487556
1 2 3 4 5 6 7 8 11 13 14 17 18 20 22 
#module 0 size: 14 bs: 0.0135818
1 2 3 4 5 6 7 8 11 13 14 17 18 22 
#module 1 size: 11 bs: 0.0324947
9 15 16 19 21 24 27 30 31 33 34 
#module 0 size: 14 bs: 0.0135818
1 2 3 4 5 6 7 8 11 13 14 17 18 22 
#module 1 size: 18 bs: 0.0160003
3 9 10 15 16 19 21 24 25 26 27 28 29 30 31 32 33 34 
#module 0 size: 18 bs: 0.0132312
3 9 10 15 16 19 21 24 25 26 27 28 29 30 31 32 33 34 
#module 1 size: 13 bs: 0.048285
1 2 4 5 6 7 8 11 13 14 17 18 22 
#module 0 size: 14 bs: 0.0135818
1 2 3 4 5 6 7 8 11 13 14 17 18 22 
#module 1 size: 18 bs: 0.0132312
3 9 10 15 16 19 21 24 25 26 27 28 29 30 31 32 33 34 
